11111111111111111
1E001010010001101
111000101001000C1
100PC0000C00000C1
11111111111111111