11111111111111111
1E001010010001101
110000101001000C1
1000C0000P00000C1
11111111111111111