1111111111111111
1000000100000011
10CCCCC10000C0E1
11110P010S00S0C1
100000C100000001
110S000000S11111
1111111111111111