111111111111111111111
1E10000011000000000C1
1C1P00000100000001111
100000000100000000011
1000000010000000C0011
10000000010000000C001
100CCCCCC0CCCCCCCCCC1
111111111111111111111
111111111111111111111
111111111111111111111