1111111
1001C01
1P00001
10CP0E1
1111111